######..
#......#
##...###
#....##.
.#..##..
.#.....#
..#.#..#
#.#.####
