....#..#
#...#.##
#.#....#
...###.#
....##..
..#...##

\robot 1 2
\robot 5 0
